##### #############
B                 
##### #############
#####              
##### #############
###               
### ###############
###         #### ## 
    ####### #### ##
########### #######
            #######
####### ###########     
####### ###########
  ##### ###########
#       ###########
# #################
# #################
#         #########
# ####### #########
#A####### #########